of --> fo
and --> dna
to --> ot
a --> a
in --> ni
is --> si
on --> no
i --> i
it --> ti
not --> ton
or --> ro
are --> era
at --> ta
as --> sa
an --> na
was --> saw
us --> su
if --> fi
but --> tub
no --> on
he --> eh
so --> os
now --> won
pm --> mp
c --> c
e --> e
am --> ma
me --> em
s --> s
x --> x
top --> pot
n --> n
re --> er
go --> og
b --> b
t --> t
d --> d
m --> m
r --> r
de --> ed
map --> pam
p --> p
part --> trap
f --> f
did --> did
dvd --> dvd
l --> l
w --> w
o --> o
g --> g
h --> h
per --> rep
law --> wal
v --> v
level --> level
non --> non
k --> k
y --> y
cd --> dc
man --> nam
j --> j
u --> u
live --> evil
tv --> vt
la --> al
pc --> cp
let --> tel
red --> der
q --> q
ii --> ii
z --> z
ca --> ac
war --> raw
nov --> von
al --> la
star --> rats
id --> di
net --> ten
co --> oc
god --> dog
et --> te
mar --> ram
st --> ts
parts --> strap
edit --> tide
en --> ne
step --> pets
oh --> ho
ad --> da
dog --> god
ny --> yn
dc --> cd
pre --> erp
ok --> ko
ms --> sm
los --> sol
hp --> ph
eg --> ge
ip --> pi
maps --> spam
pa --> ap
tel --> let
el --> le
ma --> am
mac --> cam
iii --> iii
md --> dm
fl --> lf
mb --> bm
mr --> rm
van --> nav
il --> li
pop --> pop
mm --> mm
pool --> loop
eye --> eye
ed --> de
php --> php
le --> el
az --> za
un --> nu
saw --> was
mi --> im
xxx --> xxx
sub --> bus
led --> del
ten --> net
th --> ht
flow --> wolf
dr --> rd
kb --> bk
pp --> pp
na --> an
os --> so
bob --> bob
www --> www
fi --> if
nc --> cn
bus --> sub
po --> op
va --> av
rd --> dr
sc --> cs
nor --> ron
mid --> dim
se --> es
di --> id
del --> led
ga --> ag
ac --> ca
ft --> tf
im --> mi
vs --> sv
ar --> ra
mo --> om
sa --> as
cc --> cc
wa --> aw
ave --> eva
dj --> jd
cm --> mc
ct --> tc
da --> ad
stats --> stats
hr --> rh
em --> me
iv --> vi
rw --> wr
ne --> en
nt --> tn
es --> se
spam --> maps
gb --> bg
bc --> cb
pr --> rp
fr --> rf
aa --> aa
mt --> tm
won --> now
doc --> cod
mom --> mom
mg --> gm
aim --> mia
tip --> pit
ch --> hc
sd --> ds
rs --> sr
refer --> refer
spot --> tops
dna --> and
pets --> step
tim --> mit
ss --> ss
ap --> pa
nm --> mn
mn --> nm
evil --> live
op --> po
cap --> pac
tn --> nt
raw --> war
ce --> ec
ages --> sega
ab --> ba
der --> red
cam --> mac
ram --> mar
tm --> mt
sp --> ps
draw --> ward
fm --> mf
sam --> mas
db --> bd
ph --> hp
ia --> ai
pt --> tp
psp --> psp
ha --> ah
ds --> sd
ea --> ae
lg --> gl
loop --> pool
nw --> wn
ff --> ff
ps --> sp
br --> rb
lo --> ol
ml --> lm
res --> ser
wow --> wow
cs --> sc
fig --> gif
sf --> fs
ut --> tu
tab --> bat
si --> is
mc --> cm
lp --> pl
von --> nov
ag --> ga
vi --> iv
lived --> devil
ba --> ab
cr --> rc
pg --> gp
ee --> ee
ks --> sk
med --> dem
sw --> ws
leg --> gel
hd --> dh
er --> re
jr --> rj
era --> are
dial --> laid
par --> rap
mad --> dam
su --> us
cpu --> upc
sr --> rs
nr --> rn
lol --> lol
mp --> pm
def --> fed
li --> il
nl --> ln
tr --> rt
bb --> bb
ron --> nor
dad --> dad
pat --> tap
te --> et
av --> va
radar --> radar
ward --> draw
ra --> ar
mod --> dom
rc --> cr
ec --> ce
rep --> per
mit --> tim
anna --> anna
rm --> mr
sri --> irs
nova --> avon
cf --> fc
vt --> tv
sms --> sms
xx --> xx
gm --> mg
ri --> ir
rt --> tr
cp --> pc
dd --> dd
pl --> lp
rf --> fr
ak --> ka
fe --> ef
td --> dt
sb --> bs
ah --> ha
sm --> ms
laid --> dial
ns --> sn
eve --> eve
ja --> aj
bs --> sb
sad --> das
wolf --> flow
ta --> at
pot --> top
devil --> lived
rev --> ver
ll --> ll
cl --> lc
ho --> oh
corp --> proc
sh --> hs
ae --> ea
hs --> sh
pi --> ip
ai --> ia
ot --> to
ic --> ci
tit --> tit
fed --> def
reed --> deer
mood --> doom
gr --> rg
tops --> spot
ts --> st
ge --> eg
pe --> ep
tt --> tt
aka --> aka
strap --> parts
tcp --> pct
dir --> rid
tu --> ut
rr --> rr
ef --> fe
ep --> pe
lb --> bl
jp --> pj
bt --> tb
af --> fa
rfc --> cfr
sl --> ls
isp --> psi
tc --> ct
rap --> par
gp --> pg
ir --> ri
rat --> tar
msg --> gsm
cod --> doc
cv --> vc
cb --> bc
ti --> it
fc --> cf
gel --> leg
civic --> civic
sees --> sees
gs --> sg
aaa --> aaa
bp --> pb
std --> dts
vid --> div
spots --> stops
oo --> oo
ni --> in
deer --> reed
pal --> lap
um --> mu
fs --> sf
nn --> nn
noon --> noon
proc --> corp
tan --> nat
dl --> ld
ls --> sl
boob --> boob
xanax --> xanax
sg --> gs
nav --> van
fa --> af
lc --> cl
dam --> mad
lil --> lil
das --> sad
sys --> sys
stops --> spots
cu --> uc
ws --> sw
tub --> but
np --> pn
tft --> tft
dt --> td
mem --> mem
gc --> cg
tap --> pat
ci --> ic
yn --> ny
rats --> star
cfr --> rfc
pit --> tip
gsm --> msg
pb --> bp
ton --> not
gif --> fig
jd --> dj
dm --> md
div --> vid
jc --> cj
pd --> dp
ur --> ru
wal --> law
rid --> dir
ln --> nl
uc --> cu
ld --> dl
sol --> los
bat --> tab
sap --> pas
mf --> fm
mw --> wm
nu --> un
dp --> pd
xi --> ix
ht --> th
za --> az
trap --> part
ve --> ev
rh --> hr
ooo --> ooo
bk --> kb
col --> loc
sk --> ks
oc --> co
aj --> ja
dod --> dod
om --> mo
nat --> tan
tp --> pt
jm --> mj
gis --> sig
loc --> col
cn --> nc
ver --> rev
rn --> nr
cg --> gc
ser --> res
nam --> man
ix --> xi
lit --> til
ada --> ada
tb --> bt
bm --> mb
sig --> gis
tar --> rat
rj --> jr
soc --> cos
ka --> ak
dem --> med
tide --> edit
rp --> pr
eh --> he
eva --> ave
hc --> ch
fp --> pf
jj --> jj
mas --> sam
dom --> mod
ev --> ve
cos --> soc
pac --> cap
erp --> pre
gl --> lg
dh --> hd
ro --> or
df --> fd
irs --> sri
ana --> ana
pf --> fp
uw --> wu
bd --> db
lap --> pal
hh --> hh
uh --> hu
fd --> df
bo --> ob
avon --> nova
wm --> mw
psi --> isp
pct --> tcp
wb --> bw
sn --> ns
pas --> sap
doom --> mood
gig --> gig
sas --> sas
wn --> nw
sv --> vs
dg --> gd
craps --> sparc
fo --> of
ul --> lu
ol --> lo
pn --> np
mu --> um
ala --> ala
rb --> br
upc --> cpu
gg --> gg
og --> go
ko --> ok
til --> lit
ww --> ww
sparc --> craps
gd --> dg
bw --> wb
mj --> jm
lf --> fl
ata --> ata
pam --> map
dim --> mid
wc --> cw
cj --> jc
pgp --> pgp
aw --> wa
tf --> ft
pj --> jp
cw --> wc
wr --> rw
rg --> gr
bl --> lb
vc --> cv
bg --> gb
hu --> uh
mia --> aim
ru --> ur
dts --> std
sega --> ages
wu --> uw
lu --> ul
lm --> ml
ob --> bo
