shi --> ihs
arris --> sirra
sb --> bs
steid --> diets
rebuts --> stuber
yo --> oy
tum --> mut
ok --> ko
ng --> gn
per --> rep
ged --> deg
straw --> warts
nee --> een
loom --> mool
skeeg --> geeks
tha --> aht
tres --> sert
wolf --> flow
six --> xis
lid --> dil
soe --> eos
levins --> snivel
dit --> tid
soc --> cos
am --> ma
atip --> pita
son --> nos
jar --> raj
ocas --> saco
liar --> rail
dias --> said
snab --> bans
traps --> spart
yaws --> sway
snark --> krans
mew --> wem
ties --> seit
denier --> reined
dairt --> triad
sural --> larus
siol --> lois
gat --> tag
keets --> steek
senal --> lanes
gt --> tg
cric --> circ
gut --> tug
ergate --> etagre
use --> esu
mias --> saim
deys --> syed
knaw --> wank
nema --> amen
cod --> doc
pins --> snip
aira --> aria
mt --> tm
doom --> mood
leger --> regel
mesa --> asem
af --> fa
tanna --> annat
gar --> rag
radek --> kedar
feeb --> beef
bulb --> blub
th --> ht
eire --> erie
eyah --> haye
toyos --> soyot
drag --> gard
talc --> clat
eloah --> haole
ai --> ia
dum --> mud
eras --> sare
alban --> nabla
yes --> sey
devas --> saved
spank --> knaps
dcb --> bcd
snaw --> wans
lean --> nael
aiger --> regia
tups --> sput
omen --> nemo
dormin --> nimrod
xu --> ux
arts --> stra
seric --> cires
parc --> crap
aro --> ora
sla --> als
aracana --> anacara
roop --> poor
ajar --> raja
emil --> lime
obol --> lobo
eten --> nete
sawt --> twas
redart --> trader
don --> nod
sot --> tos
speels --> sleeps
aht --> tha
fm --> mf
heres --> sereh
nim --> min
rc --> cr
delian --> nailed
allo --> olla
skeel --> leeks
strips --> spirts
peed --> deep
pas --> sap
lees --> seel
barger --> regrab
amic --> cima
malo --> olam
sv --> vs
gin --> nig
mg --> gm
nef --> fen
skips --> spiks
parts --> strap
ores --> sero
yerb --> brey
dup --> pud
eris --> sire
bats --> stab
tools --> sloot
fl --> lf
ale --> ela
ye --> ey
annot --> tonna
feif --> fief
ati --> ita
sd --> ds
snow --> wons
nut --> tun
lobo --> obol
omina --> animo
drawer --> reward
wat --> taw
dlr --> rld
puy --> yup
aped --> depa
smart --> trams
sedile --> elides
hallan --> nallah
uh --> hu
dif --> fid
bows --> swob
stressed --> desserts
kasa --> asak
neer --> reen
eh --> he
sprod --> dorps
rom --> mor
pf --> fp
yn --> ny
rag --> gar
rab --> bar
tubed --> debut
dur --> rud
say --> yas
lac --> cal
ld --> dl
tpd --> dpt
krems --> smerk
ti --> it
tib --> bit
dewans --> snawed
cr --> rc
lif --> fil
ave --> eva
anal --> lana
immun --> nummi
slipup --> pupils
dab --> bad
aria --> aira
pias --> saip
me --> em
neal --> laen
amunam --> manuma
senega --> agenes
asor --> rosa
kori --> irok
sit --> tis
spud --> dups
gangan --> nagnag
lowa --> awol
gal --> lag
mils --> slim
darter --> retrad
enid --> dine
soda --> ados
fig --> gif
draw --> ward
sil --> lis
bobac --> cabob
so --> os
saco --> ocas
maps --> spam
snub --> buns
clat --> talc
neves --> seven
aid --> dia
reel --> leer
um --> mu
dedal --> laded
az --> za
anim --> mina
subah --> habus
snip --> pins
ix --> xi
lived --> devil
sereh --> heres
meet --> teem
heuk --> kueh
oner --> reno
yug --> guy
yalb --> blay
adar --> rada
mod --> dom
tewer --> rewet
safen --> nefas
sokes --> sekos
aes --> sea
retrad --> darter
sri --> irs
fcs --> scf
mu --> um
lis --> sil
ean --> nae
amora --> aroma
debut --> tubed
auget --> tegua
pala --> alap
knots --> stonk
larus --> sural
reviler --> reliver
warb --> braw
strow --> worts
lama --> amal
tera --> aret
pave --> evap
wah --> haw
timer --> remit
nabal --> laban
mb --> bm
ds --> sd
met --> tem
nets --> sten
mr --> rm
spad --> daps
hsi --> ish
kc --> ck
wonk --> know
bog --> gob
pe --> ep
absi --> isba
fcp --> pcf
leep --> peel
pcf --> fcp
rubor --> robur
anay --> yana
epit --> tipe
vic --> civ
ba --> ab
irred --> derri
rakis --> sikar
sturts --> struts
reno --> oner
narw --> wran
gums --> smug
stop --> pots
ge --> eg
dibrom --> morbid
ergo --> ogre
deb --> bed
nael --> lean
dort --> trod
trot --> tort
kedar --> radek
anat --> tana
elan --> nale
stow --> wots
vi --> iv
harris --> sirrah
frt --> trf
snaps --> spans
km --> mk
rewarder --> redrawer
acrid --> dirca
nob --> bon
ts --> st
sa --> as
scran --> narcs
gab --> bag
fiar --> raif
kanap --> panak
dem --> med
col --> loc
wons --> snow
yon --> noy
oud --> duo
lip --> pil
dimit --> timid
salta --> atlas
devil --> lived
era --> are
regna --> anger
samen --> nemas
dat --> tad
slop --> pols
eof --> foe
lap --> pal
leg --> gel
wad --> daw
spirts --> strips
artamus --> sumatra
gurt --> trug
gu --> ug
rt --> tr
db --> bd
ulua --> aulu
sleep --> peels
ep --> pe
biga --> agib
bur --> rub
shama --> amahs
bo --> ob
imer --> remi
lime --> emil
lever --> revel
satem --> metas
slag --> gals
brut --> turb
gard --> drag
snips --> spins
stang --> gnats
gals --> slag
gnar --> rang
seg --> ges
evils --> slive
agar --> raga
delit --> tiled
daud --> duad
notes --> seton
jag --> gaj
guy --> yug
tu --> ut
reward --> drawer
tegua --> auget
tup --> put
wer --> rew
sarah --> haras
doz --> zod
dot --> tod
dan --> nad
van --> nav
wens --> snew
ante --> etna
appal --> lappa
wod --> dow
sput --> tups
leets --> steel
kcal --> lack
seracs --> scares
nog --> gon
get --> teg
yad --> day
stod --> dots
loob --> bool
faq --> qaf
yat --> tay
soud --> duos
sew --> wes
pows --> swop
snoot --> toons
bonk --> knob
ogpu --> upgo
delbert --> trebled
snew --> wens
ammos --> somma
tis --> sit
sag --> gas
tiler --> relit
anacara --> aracana
lub --> bul
esne --> ense
meed --> deem
taw --> wat
asem --> mesa
pl --> lp
stra --> arts
mets --> stem
syed --> deys
artus --> sutra
ah --> ha
well --> llew
lief --> feil
tuan --> naut
wac --> caw
seel --> lees
pps --> spp
redden --> nedder
hahs --> shah
ed --> de
erg --> gre
sore --> eros
pons --> snop
ssed --> dess
lam --> mal
log --> gol
deval --> laved
dine --> enid
amapa --> apama
peek --> keep
tinker --> reknit
loge --> egol
mao --> oam
wene --> enew
tats --> stat
remi --> imer
sabana --> anabas
nab --> ban
bt --> tb
aet --> tea
agrom --> morga
di --> id
kay --> yak
caf --> fac
il --> li
bk --> kb
sarra --> arras
eval --> lave
tig --> git
pam --> map
troper --> report
steeks --> skeets
naw --> wan
derat --> tared
mools --> sloom
esu --> use
stria --> airts
drad --> dard
wos --> sow
trets --> stert
dos --> sod
ml --> lm
trig --> girt
owl --> lwo
trams --> smart
bl --> lb
trader --> redart
twp --> pwt
dessert --> tressed
tol --> lot
neper --> repen
sessa --> asses
tom --> mot
tines --> senit
ne --> en
dob --> bod
ranid --> dinar
sn --> ns
moe --> eom
dola --> alod
pol --> lop
nu --> un
cos --> soc
mac --> cam
puns --> snup
swot --> tows
gam --> mag
tawa --> awat
susan --> nasus
word --> drow
diaper --> repaid
gn --> ng
peh --> hep
rok --> kor
later --> retal
know --> wonk
aire --> eria
haya --> ayah
dada --> adad
wk --> kw
mats --> stam
jak --> kaj
trop --> port
wran --> narw
venator --> rotanev
metas --> satem
stert --> trets
ate --> eta
wows --> swow
mab --> bam
tiu --> uit
serum --> mures
ports --> strop
enam --> mane
bom --> mob
cf --> fc
arian --> naira
repaid --> diaper
pin --> nip
yar --> ray
eel --> lee
deke --> eked
segol --> loges
lot --> tol
pacs --> scap
alma --> amla
nub --> bun
rap --> par
neet --> teen
cd --> dc
nimrod --> dormin
hoped --> depoh
adet --> teda
raga --> agar
snup --> puns
dis --> sid
tided --> dedit
mas --> sam
tink --> knit
atis --> sita
eviler --> relive
tog --> got
supa --> apus
tag --> gat
sod --> dos
fila --> alif
tonna --> annot
rm --> mr
brev --> verb
snot --> tons
sho --> ohs
ode --> edo
asak --> kasa
def --> fed
rewet --> tewer
wem --> mew
upgo --> ogpu
reified --> deifier
maid --> diam
kaes --> seak
emits --> stime
samir --> rimas
cm --> mc
pd --> dp
blub --> bulb
trebled --> delbert
selena --> aneles
stared --> derats
poort --> troop
ino --> oni
ta --> at
burt --> trub
eton --> note
vas --> sav
knob --> bonk
gon --> nog
oc --> co
dorter --> retrod
edam --> made
gv --> vg
sleets --> steels
arkab --> bakra
gtc --> ctg
olid --> dilo
scaw --> wacs
yaw --> way
delf --> fled
senit --> tines
emim --> mime
bam --> mab
prod --> dorp
vel --> lev
snug --> guns
aval --> lava
abay --> yaba
ande --> edna
troop --> poort
timo --> omit
pst --> tsp
naira --> arian
paws --> swap
gra --> arg
sorb --> bros
prat --> tarp
abas --> saba
snawed --> dewans
seit --> ties
mc --> cm
tier --> reit
nis --> sin
spp --> pps
syl --> lys
ducs --> scud
dennis --> sinned
trips --> spirt
awm --> mwa
nil --> lin
eros --> sore
fb --> bf
pols --> slop
amis --> sima
ova --> avo
turb --> brut
smuts --> stums
orig --> giro
naut --> tuan
lasso --> ossal
tax --> xat
slap --> pals
dols --> slod
bas --> sab
animal --> lamina
bins --> snib
tils --> slit
ahom --> moha
ised --> desi
spans --> snaps
vl --> lv
raw --> war
ck --> kc
pt --> tp
hp --> ph
edna --> ande
aryl --> lyra
sebat --> tabes
ret --> ter
at --> ta
sallets --> stellas
hal --> lah
tp --> pt
teemer --> remeet
hakam --> makah
teal --> laet
sw --> ws
shales --> selahs
cab --> bac
sha --> ahs
dc --> cd
redia --> aider
remeet --> teemer
namda --> adman
oda --> ado
or --> ro
trod --> dort
noxa --> axon
kaj --> jak
bits --> stib
tipe --> epit
baw --> wab
sled --> dels
neeps --> speen
derog --> gored
lysed --> desyl
nossel --> lesson
slup --> puls
pow --> wop
retool --> looter
arras --> sarra
barb --> brab
leef --> feel
knaps --> spank
lack --> kcal
yaps --> spay
olla --> allo
llew --> well
co --> oc
nae --> ean
tael --> leat
sire --> eris
sirra --> arris
dial --> laid
naf --> fan
osi --> iso
seined --> denies
hob --> boh
grus --> surg
ctg --> gtc
hoo --> ooh
scf --> fcs
allium --> muilla
bin --> nib
amahs --> shama
are --> era
yow --> woy
eked --> deke
dy --> yd
gats --> stag
laud --> dual
struts --> sturts
macs --> scam
narcs --> scran
tas --> sat
kt --> tk
fled --> delf
buns --> snub
mun --> num
nos --> son
bag --> gab
du --> ud
sris --> sirs
ser --> res
stool --> loots
time --> emit
spole --> elops
yalla --> allay
ami --> ima
dey --> yed
pacer --> recap
op --> po
air --> ria
seah --> haes
ates --> seta
stub --> buts
tn --> nt
dero --> ored
slim --> mils
nana --> anan
rotanev --> venator
scam --> macs
retar --> rater
rennet --> tenner
laded --> dedal
mk --> km
gil --> lig
org --> gro
cire --> eric
deflow --> wolfed
stor --> rots
reflog --> golfer
wob --> bow
om --> mo
tracer --> recart
raj --> jar
flor --> rolf
bro --> orb
ms --> sm
tega --> aget
skua --> auks
gib --> big
wank --> knaw
pots --> stop
dags --> sgad
sf --> fs
sexed --> dexes
arab --> bara
narc --> cran
hu --> uh
enew --> wene
mo --> om
mota --> atom
cro --> orc
rug --> gur
deeps --> speed
nefas --> safen
nasus --> susan
pah --> hap
gur --> rug
kal --> lak
nayar --> rayan
degener --> reneged
moot --> toom
paced --> decap
ezod --> doze
sav --> vas
boh --> hob
lapel --> lepal
xd --> dx
boc --> cob
gl --> lg
meets --> steem
lyra --> aryl
bed --> deb
edile --> elide
cabob --> bobac
mana --> anam
bac --> cab
ulus --> sulu
nap --> pan
pus --> sup
sprat --> tarps
bul --> lub
boa --> aob
fol --> lof
spart --> traps
tk --> kt
wm --> mw
reels --> sleer
ki --> ik
fresne --> enserf
slug --> guls
staw --> wats
gnow --> wong
demit --> timed
haes --> seah
rakes --> sekar
eves --> seve
depot --> toped
refed --> defer
sleeps --> speels
uts --> stu
eat --> tae
sned --> dens
tang --> gnat
yot --> toy
tiled --> delit
rem --> mer
meg --> gem
saa --> aas
zod --> doz
kw --> wk
dens --> sned
nidal --> ladin
dons --> snod
notice --> eciton
bv --> vb
sur --> rus
ca --> ac
sope --> epos
alga --> agla
gm --> mg
rata --> atar
reiter --> retier
lana --> anal
mis --> sim
nabla --> alban
serab --> bares
relived --> deviler
anil --> lina
ud --> du
aute --> etua
cir --> ric
two --> owt
of --> fo
noop --> poon
leat --> tael
neb --> ben
sare --> eras
report --> troper
stat --> tats
eneid --> diene
red --> der
disp --> psid
mot --> tom
mug --> gum
agas --> saga
decima --> amiced
gnu --> ung
larum --> mural
snur --> runs
bow --> wob
adad --> dada
loop --> pool
ria --> air
dole --> elod
rie --> eir
stun --> nuts
dray --> yard
vb --> bv
nasab --> basan
reef --> feer
lad --> dal
lias --> sail
foots --> stoof
redleg --> gelder
enow --> wone
fr --> rf
rees --> seer
sat --> tas
reen --> neer
sera --> ares
vs --> sv
diene --> eneid
sgad --> dags
tao --> oat
teel --> leet
moy --> yom
lys --> syl
borer --> rerob
rivel --> levir
anan --> nana
elbert --> treble
drail --> liard
sc --> cs
atar --> rata
ham --> mah
tug --> gut
sena --> anes
alap --> pala
ares --> sera
nor --> ron
pod --> dop
sutra --> artus
tanak --> kanat
girt --> trig
eta --> ate
foe --> eof
ung --> gnu
rime --> emir
sagra --> argas
stum --> muts
nig --> gin
bid --> dib
note --> eton
mob --> bom
kitab --> batik
sima --> amis
md --> dm
auks --> skua
sup --> pus
ib --> bi
fs --> sf
haras --> sarah
tor --> rot
aw --> wa
feel --> leef
sone --> enos
tonk --> knot
laton --> notal
lied --> deil
nahor --> rohan
decap --> paced
repen --> neper
fen --> nef
fires --> serif
dard --> drad
del --> led
treble --> elbert
but --> tub
leer --> reel
teer --> reet
hr --> rh
net --> ten
golf --> flog
ht --> th
gored --> derog
spools --> sloops
arf --> fra
nerol --> loren
marc --> cram
reid --> dier
strid --> dirts
lob --> bol
ais --> sia
wf --> fw
saved --> devas
cp --> pc
moor --> room
dilo --> olid
gp --> pg
wab --> baw
nale --> elan
wot --> tow
rayan --> nayar
pwt --> twp
pan --> nap
tem --> met
dow --> wod
tg --> gt
pats --> stap
nov --> von
feer --> reef
amedeo --> oedema
sh --> hs
amil --> lima
salat --> talas
tan --> nat
gen --> neg
tod --> dot
nat --> tan
burd --> drub
te --> et
marah --> haram
ab --> ba
rd --> dr
nt --> tn
laced --> decal
aas --> saa
enos --> sone
plug --> gulp
warder --> redraw
remit --> timer
ten --> net
haj --> jah
loons --> snool
unnet --> tennu
haw --> wah
fi --> if
yard --> dray
dew --> wed
arg --> gra
wag --> gaw
dilos --> solid
no --> on
ler --> rel
gud --> dug
cu --> uc
vac --> cav
aff --> ffa
yam --> may
ot --> to
stot --> tots
orc --> cro
revel --> lever
cam --> mac
morts --> strom
snib --> bins
bon --> nob
wolfer --> reflow
knits --> stink
regrab --> barger
eyl --> lye
ffa --> aff
sway --> yaws
delia --> ailed
repel --> leper
runs --> snur
sog --> gos
ceps --> spec
lah --> hal
decart --> traced
noel --> leon
reined --> denier
rew --> wer
yeh --> hey
sekos --> sokes
reflet --> telfer
kas --> sak
nav --> van
sirrah --> harris
scram --> marcs
siva --> avis
mele --> elem
guns --> snug
snoga --> agons
liv --> vil
spec --> ceps
morbid --> dibrom
lof --> fol
epop --> pope
sap --> pas
laet --> teal
nid --> din
dart --> trad
yew --> wey
pes --> sep
simara --> aramis
sal --> las
ik --> ki
mh --> hm
muts --> stum
ar --> ra
wong --> gnow
til --> lit
etas --> sate
gro --> org
reet --> teer
jah --> haj
tarps --> sprat
stums --> smuts
ron --> nor
polk --> klop
caw --> wac
saba --> abas
oy --> yo
snob --> bons
alo --> ola
hay --> yah
res --> ser
moos --> soom
mar --> ram
lion --> noil
ka --> ak
se --> es
ce --> ec
snig --> gins
redes --> seder
tennis --> sinnet
sleek --> keels
kor --> rok
sneb --> bens
saw --> was
ish --> hsi
may --> yam
denim --> mined
aider --> redia
rimas --> samir
po --> op
da --> ad
big --> gib
gnaws --> swang
steels --> sleets
nips --> spin
apod --> dopa
dia --> aid
hab --> bah
anis --> sina
guts --> stug
ct --> tc
gs --> sg
rogan --> nagor
le --> el
trid --> dirt
steem --> meets
reg --> ger
dae --> ead
tc --> ct
roc --> cor
ko --> ok
tra --> art
terra --> arret
lb --> bl
com --> moc
sarum --> muras
gis --> sig
gorb --> brog
sea --> aes
awol --> lowa
litu --> util
snoops --> spoons
cram --> marc
rater --> retar
tare --> erat
maes --> seam
abut --> tuba
nit --> tin
duad --> daud
fa --> af
reliver --> reviler
nak --> kan
barf --> frab
mina --> anim
knit --> tink
moc --> com
lare --> eral
dx --> xd
su --> us
dp --> pd
gips --> spig
said --> dias
kanat --> tanak
triad --> dairt
retrod --> dorter
diets --> steid
damon --> nomad
ec --> ce
tun --> nut
swap --> paws
beg --> geb
utinam --> manitu
epos --> sope
abrood --> doorba
fil --> lif
mi --> im
ug --> gu
deer --> reed
rosa --> asor
gater --> retag
ha --> ah
bens --> sneb
id --> di
snap --> pans
las --> sal
lo --> ol
shoo --> oohs
rim --> mir
aret --> tera
vips --> spiv
ezan --> naze
knut --> tunk
wa --> aw
seven --> neves
mane --> enam
ned --> den
rh --> hr
sg --> gs
tool --> loot
step --> pets
gulp --> plug
spay --> yaps
tunk --> knut
sita --> atis
dinar --> ranid
fe --> ef
gad --> dag
circ --> cric
kuar --> rauk
mf --> fm
tae --> eat
yap --> pay
daws --> swad
day --> yad
flow --> wolf
bop --> pob
pulp --> plup
ppa --> app
dahs --> shad
yas --> say
dil --> lid
oba --> abo
dian --> naid
depots --> stoped
dam --> mad
gel --> leg
loot --> tool
too --> oot
an --> na
pupils --> slipup
elide --> edile
vt --> tv
eels --> slee
slew --> wels
timed --> demit
mad --> dam
seme --> emes
recit --> ticer
cares --> serac
ak --> ka
aob --> boa
recaps --> spacer
reman --> namer
zo --> oz
alif --> fila
dies --> seid
brey --> yerb
rud --> dur
jat --> taj
bod --> dob
panak --> kanap
bohor --> rohob
bim --> mib
noil --> lion
amrit --> tirma
beef --> feeb
soyot --> toyos
oedema --> amedeo
tuts --> stut
eer --> ree
sab --> bas
olam --> malo
tad --> dat
ric --> cir
yerd --> drey
ram --> mar
lone --> enol
taen --> neat
luxe --> exul
anon --> nona
anes --> sena
reaps --> spaer
kra --> ark
nod --> don
raja --> ajar
mures --> serum
navis --> sivan
mela --> alem
tal --> lat
snum --> muns
suto --> otus
manuma --> amunam
fo --> of
mes --> sem
dub --> bud
agag --> gaga
mho --> ohm
rebut --> tuber
nias --> sain
blay --> yalb
tow --> wot
trace --> ecart
poohs --> shoop
av --> va
rf --> fr
muras --> sarum
lak --> kal
ted --> det
slab --> bals
wap --> paw
port --> trop
rolf --> flor
alas --> sala
pool --> loop
dirt --> trid
dep --> ped
neti --> iten
argas --> sagra
gul --> lug
nori --> iron
mer --> rem
pets --> step
wi --> iw
batik --> kitab
dal --> lad
exul --> luxe
cis --> sic
strig --> girts
enema --> amene
oof --> foo
saps --> spas
trf --> frt
lamed --> demal
anabas --> sabana
iron --> nori
tm --> mt
tay --> yat
stinker --> reknits
spaer --> reaps
gup --> pug
grad --> darg
recap --> pacer
tip --> pit
stoof --> foots
loc --> col
knar --> rank
deem --> meed
demal --> lamed
sak --> kas
namaz --> zaman
epa --> ape
eq --> qe
seral --> lares
swots --> stows
pal --> lap
otus --> suto
setule --> elutes
num --> mun
spale --> elaps
guv --> vug
nete --> eten
pu --> up
raps --> spar
el --> le
bar --> rab
sloot --> tools
derah --> hared
spins --> snips
reknit --> tinker
spag --> gaps
rats --> star
sate --> etas
zeus --> suez
dits --> stid
palp --> plap
bals --> slab
yah --> hay
pees --> seep
ead --> dae
laved --> deval
atokal --> lakota
mool --> loom
tagus --> sugat
ped --> dep
vog --> gov
elutes --> setule
stag --> gats
lawed --> dewal
reveler --> relever
ux --> xu
tic --> cit
tops --> spot
skel --> leks
snod --> dons
airts --> stria
gnat --> tang
pc --> cp
rea --> aer
eral --> lare
neep --> peen
dom --> mod
bares --> serab
pals --> slap
got --> tog
aile --> elia
elides --> sedile
soras --> saros
mae --> eam
din --> nid
ecca --> acce
sam --> mas
regal --> lager
sia --> ais
edit --> tide
meter --> retem
gelder --> redleg
waled --> delaw
sad --> das
nark --> kran
hales --> selah
geb --> beg
fine --> enif
mart --> tram
og --> go
tips --> spit
naze --> ezan
sed --> des
dorps --> sprod
cires --> seric
bird --> drib
bah --> hab
part --> trap
scolb --> blocs
gaz --> zag
ag --> ga
ola --> alo
gid --> dig
maws --> swam
lc --> cl
dual --> laud
wone --> enow
desyl --> lysed
mia --> aim
em --> me
eg --> ge
emes --> seme
das --> sad
dewal --> lawed
namer --> reman
dace --> ecad
agos --> soga
lager --> regal
makah --> hakam
dag --> gad
doob --> bood
gaj --> jag
ges --> seg
pug --> gup
rara --> arar
poh --> hop
reeks --> skeer
eria --> aire
drab --> bard
rewed --> dewer
rail --> liar
segar --> rages
dioramas --> samaroid
seder --> redes
bot --> tob
toy --> yot
ban --> nab
bots --> stob
doze --> ezod
lm --> ml
lamina --> animal
enamor --> romane
sumatra --> artamus
nag --> gan
rohob --> bohor
tuba --> abut
nifle --> elfin
skeets --> steeks
fiel --> leif
paler --> relap
etc --> cte
egrid --> dirge
snool --> loons
he --> eh
qe --> eq
drow --> word
er --> re
duc --> cud
emit --> time
pil --> lip
flew --> welf
sunil --> linus
sued --> deus
sl --> ls
blocs --> scolb
erat --> tare
guls --> slug
repot --> toper
bank --> knab
reed --> deer
nam --> man
stm --> mts
ow --> wo
nl --> ln
ward --> draw
bcd --> dcb
lee --> eel
let --> tel
iten --> neti
namma --> amman
on --> no
dui --> iud
teen --> neet
diva --> avid
brag --> garb
slive --> evils
eyr --> rye
fra --> arf
sumac --> camus
diols --> sloid
regia --> aiger
sisi --> isis
foo --> oof
gas --> sag
tim --> mit
reb --> ber
romane --> enamor
ni --> in
ohoy --> yoho
sirup --> puris
war --> raw
gre --> erg
stew --> wets
redips --> spider
pad --> dap
ut --> tu
een --> nee
lod --> dol
ella --> alle
dor --> rod
tennu --> unnet
gets --> steg
en --> ne
lien --> neil
lev --> vel
eva --> ave
retem --> meter
man --> nam
hoop --> pooh
pita --> atip
xat --> tax
apay --> yapa
bara --> arab
span --> naps
poon --> noop
ster --> rets
tenner --> rennet
ea --> ae
cure --> eruc
asana --> anasa
annat --> tanna
pools --> sloop
denies --> seined
sacro --> orcas
pen --> nep
lina --> anil
stonk --> knots
st --> ts
dewer --> rewed
cele --> elec
ored --> dero
nib --> bin
taj --> jat
seed --> dees
eo --> oe
swang --> gnaws
swep --> pews
nb --> bn
enrib --> birne
ver --> rev
swop --> pows
et --> te
laban --> nabal
nar --> ran
ile --> eli
uc --> cu
cyl --> lyc
brog --> gorb
spar --> raps
lop --> pol
terces --> secret
dys --> syd
cran --> narc
tam --> mat
nallah --> hallan
dr --> rd
oz --> zo
keep --> peek
niter --> retin
reve --> ever
rel --> ler
tew --> wet
spots --> stops
al --> la
manes --> senam
sem --> mes
morga --> agrom
drib --> bird
amene --> enema
agons --> snoga
ey --> ye
put --> tup
toom --> moot
had --> dah
derri --> irred
lyc --> cyl
art --> tra
anasa --> asana
kb --> bk
seri --> ires
derats --> stared
xed --> dex
loops --> spool
detar --> rated
decal --> laced
la --> al
stut --> tuts
ac --> ca
noh --> hon
strom --> morts
trapa --> apart
sugat --> tagus
trah --> hart
arret --> terra
us --> su
marg --> gram
yoho --> ohoy
enserf --> fresne
swans --> snaws
xema --> amex
munger --> regnum
pooh --> hoop
gaw --> wag
otc --> cto
sports --> strops
atlas --> salta
lati --> ital
dedit --> tided
birne --> enrib
ever --> reve
dier --> reid
habus --> subah
yd --> dy
rn --> nr
emir --> rime
tr --> rt
eom --> moe
mag --> gam
tid --> dit
wets --> stew
nagnag --> gangan
scares --> seracs
ital --> lati
rot --> tor
adman --> namda
liard --> drail
ph --> hp
ossal --> lasso
yaba --> abay
tos --> sot
skees --> seeks
sleb --> bels
dl --> ld
reh --> her
beid --> dieb
ura --> aru
sic --> cis
bakra --> arkab
ras --> sar
lave --> eval
bood --> doob
rev --> ver
amelu --> ulema
kral --> lark
elaps --> spale
rots --> stor
as --> sa
annam --> manna
gaps --> spag
qp --> pq
serif --> fires
girts --> strig
klop --> polk
knows --> swonk
wet --> tew
sulu --> ulus
seep --> pees
ger --> reg
camus --> sumac
amiced --> decima
lav --> val
surg --> grus
marts --> stram
star --> rats
oh --> ho
nona --> anon
sung --> gnus
seton --> notes
wey --> yew
naim --> mian
sp --> ps
poor --> roop
saga --> agas
cud --> duc
nm --> mn
ladin --> nidal
nuts --> stun
stu --> uts
bruted --> deturb
pac --> cap
up --> pu
looter --> retool
dir --> rid
bs --> sb
fac --> caf
tram --> mart
moha --> ahom
ps --> sp
ohm --> mho
amar --> rama
egol --> loge
peen --> neep
sten --> nets
etagre --> ergate
soga --> agos
snit --> tins
stows --> swots
amos --> soma
trap --> part
wels --> slew
it --> ti
yob --> boy
oven --> nevo
ela --> ale
remital --> latimer
bor --> rob
dexes --> sexed
uit --> tiu
solod --> dolos
orb --> bro
util --> litu
worts --> strow
fred --> derf
sloops --> spools
pot --> top
regel --> leger
tsp --> pst
is --> si
hw --> wh
tin --> nit
twos --> sowt
soma --> amos
rerob --> borer
dg --> gd
retin --> niter
dop --> pod
sowt --> twos
peel --> leep
bray --> yarb
new --> wen
suez --> zeus
pa --> ap
gan --> nag
frab --> barf
cav --> vac
retier --> reiter
bra --> arb
golfer --> reflog
was --> saw
tab --> bat
mural --> larum
dool --> lood
few --> wef
pret --> terp
sleer --> reels
haye --> eyah
wort --> trow
suber --> rebus
nemas --> samen
teg --> get
pans --> snap
leper --> repel
gnats --> stang
stob --> bots
bf --> fb
aer --> rea
pob --> bop
bit --> tib
snivel --> levins
wolfed --> deflow
stuber --> rebuts
za --> az
yak --> kay
sprits --> stirps
elec --> cele
stem --> mets
stoped --> depots
relit --> tiler
leon --> noel
ado --> oda
offer --> reffo
rages --> segar
obmit --> timbo
mime --> emim
tb --> bt
trad --> dart
spot --> tops
cart --> trac
grub --> burg
awat --> tawa
neil --> lien
nip --> pin
timbo --> obmit
to --> ot
rauk --> kuar
navi --> ivan
room --> moor
porc --> crop
gawgaw --> wagwag
rep --> per
asses --> sessa
sapin --> nipas
bun --> nub
ense --> esne
tanga --> agnat
peels --> sleep
ay --> ya
daraf --> farad
qaf --> faq
ton --> not
lood --> dool
territ --> tirret
relap --> paler
stops --> spots
darts --> strad
basan --> nasab
sar --> ras
ws --> sw
fief --> feif
wen --> new
toped --> depot
animo --> omina
seid --> dies
prep --> perp
sevier --> reives
yana --> anay
nagor --> rogan
dels --> sled
hart --> trah
rada --> adar
tort --> trot
teda --> adet
sm --> ms
lava --> aval
tenon --> nonet
na --> an
nd --> dn
regnum --> munger
leif --> fiel
noy --> yon
darb --> brad
swat --> taws
doorba --> abrood
doeg --> geod
wop --> pow
owt --> two
evil --> live
rohan --> nahor
mir --> rim
top --> pot
ita --> ati
dopa --> apod
crop --> porc
slone --> enols
edo --> ode
ga --> ag
nad --> dan
lug --> gul
tuber --> rebut
agenes --> senega
sammel --> lemmas
relever --> reveler
ken --> nek
oad --> dao
qs --> sq
li --> il
dn --> nd
spat --> taps
wh --> hw
rial --> lair
wo --> ow
pm --> mp
vil --> liv
do --> od
shu --> uhs
hop --> poh
slit --> tils
sig --> gis
elod --> dole
crap --> parc
ra --> ar
nedder --> redden
stime --> emits
shad --> dahs
deil --> lied
fool --> loof
lamas --> samal
tur --> rut
plap --> palp
selah --> hales
alem --> mela
serg --> gres
app --> ppa
hared --> derah
lair --> rial
stam --> mats
elia --> aile
mon --> nom
tows --> swot
nek --> ken
saim --> mias
mooder --> redoom
sward --> draws
wats --> staw
steel --> leets
irs --> sri
eciton --> notice
ben --> neb
dug --> gud
mal --> lam
manitu --> utinam
der --> red
sum --> mus
rod --> dor
salem --> melas
not --> ton
meer --> reem
farad --> daraf
wang --> gnaw
mib --> bim
sloid --> diols
sevres --> serves
mows --> swom
boar --> raob
eam --> mae
zag --> gaz
sin --> nis
yom --> moy
lg --> gl
amman --> namma
mah --> ham
aramis --> simara
mil --> lim
alod --> dola
zaman --> namaz
wan --> naw
decurt --> truced
nemo --> omen
leks --> skel
spit --> tips
sark --> kras
levir --> rivel
gins --> snig
loren --> nerol
speen --> neeps
eos --> soe
spoons --> snoops
duos --> soud
spider --> redips
ym --> my
strap --> parts
mian --> naim
kip --> pik
naid --> dian
ume --> emu
sip --> pis
neve --> even
sinned --> dennis
sala --> alas
mw --> wm
lares --> seral
lab --> bal
anger --> regna
lark --> kral
amal --> lama
boy --> yob
fro --> orf
raif --> fiar
pud --> dup
cv --> vc
sirs --> sris
bus --> sub
reis --> sier
seer --> rees
agla --> alga
irok --> kori
scud --> ducs
pank --> knap
vc --> cv
strops --> sports
liever --> reveil
stirps --> sprits
stellas --> sallets
ecart --> trace
god --> dog
iw --> wi
trow --> wort
stab --> bats
nipas --> sapin
marcs --> scram
smug --> gums
depa --> aped
des --> sed
seak --> kaes
plup --> pulp
rye --> eyr
steek --> keets
shah --> hahs
lit --> til
dirge --> egrid
fid --> dif
tel --> let
cob --> boc
rob --> bor
apama --> amapa
lapon --> nopal
tob --> bot
redraw --> warder
bud --> dub
atap --> pata
knot --> tonk
burg --> grub
eruc --> cure
ako --> oka
hm --> mh
pig --> gip
ened --> dene
od --> do
ya --> ay
agama --> amaga
sel --> les
wef --> few
ford --> drof
dene --> ened
draws --> sward
talas --> salat
yup --> puy
saip --> pias
mpg --> gpm
seek --> kees
rub --> bur
mts --> stm
mined --> denim
tared --> derat
gnus --> sung
apus --> supa
ark --> kra
lwo --> owl
nomad --> damon
hq --> qh
lag --> gal
agger --> regga
als --> sla
gnome --> emong
eliot --> toile
seor --> roes
ob --> bo
reit --> tier
apart --> trapa
degami --> imaged
rima --> amir
assam --> massa
ray --> yar
wagwag --> gawgaw
dirts --> strid
redrawer --> rewarder
dah --> had
ailed --> delia
rip --> pir
slee --> eels
pay --> yap
tons --> snot
nailed --> delian
sr --> rs
dig --> gid
etna --> ante
reveil --> liever
nye --> eyn
neg --> gen
lesson --> nossel
gem --> meg
oam --> mao
atom --> mota
stib --> bits
det --> ted
seam --> maes
amaga --> agama
neat --> taen
sotol --> lotos
ln --> nl
ap --> pa
reviled --> deliver
smur --> rums
stoot --> toots
relive --> eviler
orf --> fro
tea --> aet
agnat --> tanga
snop --> pons
won --> now
tsuga --> agust
bd --> db
hap --> pah
turp --> prut
syd --> dys
fp --> pf
flog --> golf
ivan --> navi
seeks --> skees
es --> se
rus --> sur
isis --> sisi
diorama --> amaroid
pews --> swep
elem --> mele
led --> del
nummi --> immun
wots --> stow
arum --> mura
samaroid --> dioramas
soom --> moos
bi --> ib
yapa --> apay
mood --> doom
les --> sel
trug --> gurt
von --> nov
loots --> stool
kueh --> heuk
drof --> ford
sop --> pos
gip --> pig
nolos --> solon
etua --> aute
leben --> nebel
garb --> brag
muns --> snum
sib --> bis
cor --> roc
pit --> tip
avo --> ova
senam --> manes
tub --> but
massa --> assam
td --> dt
spiv --> vips
agust --> tsuga
rums --> smur
notal --> laton
sey --> yes
has --> sah
aulu --> ulua
sid --> dis
dialer --> relaid
sub --> bus
retros --> sorter
proc --> corp
corp --> proc
dol --> lod
daps --> spad
loos --> sool
oot --> too
sikar --> rakis
lemmas --> sammel
spiks --> skips
gorse --> esrog
nep --> pen
sivan --> navis
mat --> tam
dpt --> tpd
atef --> feta
latimer --> remital
taps --> spat
ticer --> recit
wares --> seraw
gov --> vog
pos --> sop
dex --> xed
desi --> ised
git --> tig
iv --> vi
seraw --> wares
amex --> xema
pir --> rip
mura --> arum
ns --> sn
spt --> tps
nus --> sun
bat --> tab
swam --> maws
ist --> tsi
si --> is
val --> lav
redoom --> mooder
eyn --> nye
wans --> snaw
swonk --> knows
rad --> dar
dorp --> prod
deus --> sued
aroma --> amora
cul --> luc
kips --> spik
tirret --> territ
emu --> ume
im --> mi
rat --> tar
gol --> log
tana --> anat
evap --> pave
even --> neve
avis --> siva
luc --> cul
spas --> saps
lf --> fl
amla --> alma
made --> edam
doh --> hod
welf --> flew
ad --> da
sert --> tres
shoop --> poohs
amaroid --> diorama
tav --> vat
acara --> araca
aim --> mia
deviler --> relived
toop --> poot
sob --> bos
ohs --> sho
yor --> roy
bm --> mb
dap --> pad
perp --> prep
toots --> stoot
sina --> anis
deg --> ged
araca --> acara
wacs --> scaw
arb --> bra
teem --> meet
knap --> pank
amen --> nema
rood --> door
now --> won
lye --> eyl
gob --> bog
psid --> disp
lappa --> appal
swom --> mows
xi --> ix
reem --> meer
obi --> ibo
dieb --> beid
repins --> sniper
rank --> knar
stink --> knits
eir --> rie
dar --> rad
hon --> noh
raob --> boar
yan --> nay
sim --> mis
auk --> kua
ulema --> amelu
krans --> snark
daw --> wad
qh --> hq
yarb --> bray
gym --> myg
bal --> lab
lv --> vl
lima --> amil
mwa --> awm
hey --> yeh
trub --> burt
knub --> bunk
defer --> refed
swow --> wows
abo --> oba
bn --> nb
kan --> nak
lira --> aril
dees --> seed
solid --> dilos
samal --> lamas
derf --> fred
ter --> ret
geod --> doeg
truced --> decurt
terp --> pret
go --> og
isba --> absi
stap --> pats
mud --> dum
muilla --> allium
spam --> maps
dog --> god
buts --> stub
bard --> drab
esrog --> gorse
xis --> six
caba --> abac
aneles --> selena
tap --> pat
telfer --> reflet
feta --> atef
rebus --> suber
sclat --> talcs
sail --> lias
myg --> gym
brab --> barb
dm --> md
gif --> fig
tressed --> dessert
delaw --> waled
her --> reh
cte --> etc
livre --> ervil
haole --> eloah
rld --> dlr
speed --> deeps
loges --> segol
in --> ni
emong --> gnome
stug --> guts
tabes --> sebat
lakota --> atokal
kees --> seek
tirma --> amrit
trib --> birt
regga --> agger
ires --> seri
solon --> nolos
spik --> kips
omit --> timo
deliver --> reviled
elfin --> nifle
lim --> mil
ervil --> livre
vug --> guv
tef --> fet
ae --> ea
sier --> reis
nevoy --> yoven
relevel --> leveler
pis --> sip
loord --> drool
par --> rap
aru --> ura
sah --> has
imaged --> degami
mid --> dim
bol --> lob
wes --> sew
nay --> yan
pq --> qp
ahs --> sha
fet --> tef
sok --> kos
kua --> auk
axon --> noxa
rg --> gr
fan --> naf
rets --> ster
duel --> leud
cit --> tic
keel --> leek
nebel --> leben
kras --> sark
hcb --> bch
cars --> srac
lanes --> senal
gim --> mig
ihs --> shi
gpm --> mpg
ro --> or
retag --> gater
slod --> dols
knab --> bank
rang --> gnar
dups --> spud
daer --> read
puls --> slup
mop --> pom
enif --> fine
timid --> dimit
ew --> we
uhs --> shu
loof --> fool
trac --> cart
avid --> diva
sep --> pes
birt --> trib
gor --> rog
ados --> soda
pik --> kip
bons --> snob
enol --> lone
gd --> dg
pg --> gp
sekar --> rakes
tsi --> ist
gram --> marg
serves --> sevres
leet --> teel
live --> evil
suras --> sarus
yoven --> nevoy
reffo --> offer
swad --> daws
ny --> yn
ayah --> haya
seta --> ates
bad --> dab
agib --> biga
oni --> ino
haram --> marah
leek --> keel
toile --> eliot
spin --> nips
bool --> loob
lepal --> lapel
we --> ew
leeks --> skeel
leven --> nevel
gres --> serg
ber --> reb
deifier --> reified
ecad --> dace
sloop --> pools
selahs --> shales
ibo --> obi
drey --> yerd
kran --> nark
semina --> animes
linus --> sunil
dt --> td
mn --> nm
iso --> osi
drool --> loord
lp --> pl
woy --> yow
steg --> gets
eli --> ile
sow --> wos
sun --> nus
bis --> sib
rated --> detar
anam --> mana
ol --> lo
deturb --> bruted
gaga --> agag
spig --> gips
mor --> rom
toper --> repot
door --> rood
ma --> am
fw --> wf
retal --> later
dim --> mid
somma --> ammos
mus --> sum
drub --> burd
snaws --> swans
tarp --> prat
seve --> eves
eric --> cire
pope --> epop
prut --> turp
ihp --> phi
hl --> lh
twas --> sawt
hep --> peh
fc --> cf
rut --> tur
reives --> sevier
nevo --> oven
evan --> nave
nopal --> lapon
keels --> sleek
robur --> rubor
gnaw --> wang
recart --> tracer
talcs --> sclat
pom --> mop
bunk --> knub
tps --> spt
mp --> pm
diam --> maid
animes --> semina
mig --> gim
lin --> nil
ima --> ami
spool --> loops
cima --> amic
dolos --> solod
ora --> aro
abac --> caba
duo --> oud
rama --> amar
ran --> nar
map --> pam
stid --> dits
sq --> qs
de --> ed
melas --> salem
cap --> pac
read --> daer
dess --> ssed
arar --> rara
aget --> tega
onces --> secno
ho --> oh
lat --> tal
scap --> pacs
naps --> span
spirt --> trips
cto --> otc
sain --> nias
ape --> epa
min --> nim
nom --> mon
cal --> lac
depoh --> hoped
sarus --> suras
snoop --> poons
gos --> sog
pat --> tap
darg --> grad
iud --> dui
rog --> gor
erie --> eire
oka --> ako
oe --> eo
tins --> snit
cs --> sc
braw --> warb
wed --> dew
tots --> stot
puris --> sirup
nevel --> leven
atte --> etta
rs --> sr
mit --> tim
dirca --> acrid
den --> ned
gum --> mug
sinnet --> tennis
feil --> lief
dao --> oad
reknits --> stinker
enols --> slone
secret --> terces
kos --> sok
orcas --> sacro
ia --> ai
alle --> ella
amir --> rima
leveler --> relevel
re --> er
fer --> ref
desserts --> stressed
skeer --> reeks
sero --> ores
manna --> annam
deep --> peed
bans --> snab
dib --> bid
rid --> dir
nonet --> tenon
annus --> sunna
ogre --> ergo
secno --> onces
ef --> fe
ls --> sl
fed --> def
vat --> tav
doc --> cod
roes --> seor
ree --> eer
leud --> duel
lig --> gil
os --> so
roy --> yor
poons --> snoop
giro --> orig
cl --> lc
oat --> tao
lh --> hl
verb --> brev
elops --> spole
aril --> lira
laid --> dial
relaid --> dialer
laen --> neal
sniper --> repins
tar --> rat
pata --> atap
bch --> hcb
saros --> soras
geeks --> skeeg
yed --> dey
sorter --> retros
brad --> darb
nave --> evan
ref --> fer
civ --> vic
tide --> edit
tv --> vt
hod --> doh
reflow --> wolfer
un --> nu
bos --> sob
sool --> loos
ooh --> hoo
my --> ym
med --> dem
smerk --> krems
traced --> decart
bros --> sorb
serac --> cares
hs --> sh
va --> av
strad --> darts
allay --> yalla
oohs --> shoo
swob --> bows
poot --> toop
strop --> ports
way --> yaw
spacer --> recaps
reneged --> degener
mut --> tum
gr --> rg
lois --> siol
phi --> ihp
stram --> marts
nr --> rn
srac --> cars
taws --> swat
dots --> stod
toons --> snoot
sunna --> annus
vg --> gv
paw --> wap
sloom --> mools
acce --> ecca
etta --> atte
if --> fi
lotos --> sotol
warts --> straw
bels --> sleb
